액터 배치 - 비주얼이펙트 - 스카이 애트머스피어(배경화면을 조성할 수 있다, 주변광에 대한 라이트 맵을 빌드해준다.)
디렉셔널 라이트 - 디테일 창의 "애트머스피어 및 클라우드"에서 여러가지 설정 가능
디렉셔널 라이트 - 라이트 컬러, 색 온도
지오메트리 - 심플한 틀을 만들 수 있는 툴

스포트 라이트 - IES 텍스처 사용(안보일 경우 톱니바퀴 눌러서 엔진 콘텐츠 표시 활성화)

오파시티 마스크 : 1이면 그려지고 0이면 안그려짐

나나이트 : 삼각형을 거리에 따라서 LOD해줌?

마테리얼의 Two Sided를 선택하면 뒷면도 보인다.

노멀방향 얻기 WS

메쉬 우클릭 - 나나이트 활성화 + 메쉬 디테일 창 나나이트 지원 활성화 체크

움직임 -> Panner
빛 -> emissive Color
기본 색상 -> Base Color
튀어나온 부분 -> world Position Offset

모델링 모드 -> 모양 선택하고 수락 -> (MeshOps의)Remesh로 버텍스 수 증가

메테리얼 인스턴싱 -> 메테리얼 우클릭한 후 인스턴스 생성 누르면 됨 : 파라메터로 만든것들은 수정해도 컴파일을 하지 않아도 된다.

Fresnel : 카메라와의 각도가 작을 수록 작은? 값을 얻을 수 있다.

subsurface color활성화 : shading Model을 수정
오파시티가 작을 수록 subsurface의 영향이 커진다.

엠비언트 오클루전 : 차폐정도에 따라 셀프 쉐도우, 
			미세한 광량 차이 표현, 
			표면의 작은 틈에 생기는 그림자, 
			Light mobility : 스태틱, 
			스테이셔너리에서만 작동함. 
			Lumen Global Illumination Method일 경우 사용이 제한됨

Lumen Global Illumination Method 해제 : 프로젝트 세팅 - 다이내믹 글로벌 이루미네이션 메서드를 스크린 스페이스로 바꿈.

TwoSidedSign : 



1. UV 변형 => 철조망, 대각선 철조망, 지그재그, 프레임, 
2. 물방울 vs 물결
3. 파(동)
4. 물 표면


Time으로 시간을 얻을 수 있다. 단위는 초
Pannel : UV좌표를 초당 수치만큼 옮겨라.

UV좌표를 생성해서 객체의 크기가 바뀌어도 그려지는 텍스쳐의 크기는 변하지 않도록 할 수 있다. z축을 해결하는 방법도 알아서 찾아보자.

VertexNormalWS에 mask를 취해 B를 빼내면 월드에서 아래쪽인 부분(saturate을 하면 아래쪽인 부분이 0이 된다.)을 추출할 수 있다.

CheepContrast : 젖어 있는 느낌을 준다.

라이팅 포함 - 버퍼 보기 - 전체 보기

화면전체에 PostProcess 설정 : PostProcessVolume 액터 - 디테일 창의 무한 규모
	Bloom : 빛 번짐, Chromatit Aberration : 자성 테이프가 잘못 읽힌것 처럼 나타냄 , Dirt Mask : 빛을 받으면 설정된 텍스쳐가 비쳐보이는 효과(비문증 효과?)
	Lens Flare : 카메라 렌즈로 빛이 산란되는 것, Depth Of Field : 씬의 포커스 지점 앞이나 뒷부분을 거리에 따라 흐리게 만드는 기법 + Camera옵션과 연관됨
	Misc : 색의 온도?를 추가해줌


셀 쉐이딩 할때 : 글로벌 이루미네이션 Lumen->None + 리플렉션 Lumen + None
안티 에일리어싱 메서드도 꺼보자.

